27 25 25 25 25 25 25 25 25 26 25 27 25 25 25 25 25 25 25 25 25 25 25 25 25 25 25 25 25 25 26 25 27 25 25 25 25 25 25 25 25 25 25 27 25 25 25 25 25 26
25 25 26 25 25 25 25 25 25 25 25 25 25 25 25 25 25 25 25 25 25 25 25 25 25 25 25 25 25 25 25 25 25 25 25 25 25 26 25 25 25 25 25 26 25 25 27 25 25 25
27 25 25 25 27 25 25 25 25 25 25 25 25 25 25 25 27 25 25 25 25 25 25 25 25 26 27 25 25 25 25 25 25 25 27 25 25 25 25 25 27 25 25 25 25 25 25 25 25 25
25 25 25 25 25 25 25 25 26 25 25 25 25 25 25 25 25 25 25 25 25 25 25 25 25 25 25 25 25 25 25 25 25 25 25 25 25 25 25 25 25 25 25 25 26 25 25 25 25 25
25 25 25 25 25 25 25 25 25 25 25 25 25 25 25 25 25 25 25 25 25 27 26 25 25 25 25 25 25 25 25 25 25 26 25 25 25 25 25 25 26 25 25 25 25 25 25 26 25 25
25 27 26 25 25 25 25 25 25 25 25 25 25 25 25 25 25 25 25 25 25 25 25 25 25 25 25 25 25 25 25 25 25 25 25 25 25 25 25 25 25 25 25 25 25 25 25 25 25 25
25 25 25 25 25 25 36 35 35 35 35 35 35 35 35 35 35 35 35 37 10 10 36 35 35 35 35 35 35 35 35 35 35 35 35 35 35 37 36 35 35 35 37 26 25 25 25 25 25 25
25 25 25 25 25 25 32 10 10 10 10 10 10 10 10 10 10 10 10 31 10 10 32 10 10 10 10 10 10 10 10 10 10 10 10 10 10 33 34 10 10 10 33 37 27 25 25 25 26 25
25 25 25 25 25 25 32 10 10 10 10 10 10 10 10 10 10 10 10 31 10 10 32 10 10 10 10 10 10 10 10 10 10 10 10 10 10 10 10 10 10 10 10 31 25 25 25 25 25 25
25 26 25 25 25 25 32 10 10 10 10 10 10 10 10 10 10 10 10 33 35 35 34 10 10 10 10 10 10 10 10 10 10 10 10 10 10 10 10 10 10 10 10 31 25 26 25 25 27 25
25 25 25 25 25 25 32 10 10 10 10 10 10 10 10 10 10 10 10 10 10 10 10 10 10 10 10 10 10 10 10 10 10 10 10 10 42 42 42 10 10 10 10 31 25 25 25 25 25 25
25 27 25 25 25 25 32 10 10 10 10 10 10 10 10 10 10 10 10 10 10 10 10 10 10 10 10 10 10 10 10 10 10 10 10 10 42 41 42 10 10 10 10 31 25 25 25 25 25 25
25 25 25 25 25 25 32 10 10 10 10 10 10 10 10 10 10 10 10 10 10 10 10 10 10 10 10 10 10 10 10 10 10 10 10 10 42 41 42 10 10 10 10 31 25 25 25 25 25 25
25 25 25 25 25 25 32 10 10 10 10 10 10 10 10 10 10 10 10 10 10 10 10 10 10 10 10 10 10 10 10 10 10 10 10 10 42 41 42 10 10 10 10 31 25 25 25 25 25 25
25 25 27 26 25 25 32 10 10 10 10 10 10 10 10 10 10 10 10 10 10 10 10 10 10 10 10 10 10 10 10 10 10 10 10 10 10 10 10 10 10 10 10 31 25 25 25 25 25 27
25 26 25 25 25 25 32 10 10 10 10 10 10 10 10 10 10 10 10 10 10 10 10 10 10 10 10 10 10 10 10 10 10 10 10 10 10 10 10 10 10 10 10 31 25 25 25 25 25 25
25 25 25 25 25 25 32 10 10 10 10 10 10 10 10 10 10 10 10 10 10 10 10 10 10 10 10 10 10 10 10 10 10 10 10 10 10 10 10 10 10 10 10 31 25 25 25 25 25 25
25 25 25 25 25 25 32 10 10 10 10 10 10 10 10 10 10 10 10 10 10 10 10 10 10 10 10 10 10 10 10 10 10 10 10 10 10 10 10 10 10 10 10 31 25 26 27 25 25 25
25 25 25 25 27 25 38 29 10 10 10 10 10 10 10 10 10 10 10 10 10 10 10 10 10 10 10 28 30 29 10 10 10 10 10 10 10 10 10 10 10 10 10 31 25 25 25 25 25 25
25 25 26 25 25 25 10 32 10 10 10 10 10 10 10 10 10 10 10 10 10 10 10 10 10 10 10 31 27 32 10 10 10 10 10 10 10 10 10 10 10 10 10 31 25 25 26 25 25 25
25 25 25 25 25 25 10 32 10 10 10 10 10 10 10 10 10 10 10 10 10 10 10 10 10 10 10 33 35 34 10 10 10 10 10 10 10 10 10 10 10 10 10 31 25 25 25 25 25 25
25 25 25 27 25 25 10 32 10 10 10 10 10 10 10 10 10 10 10 10 10 10 10 10 10 10 10 10 10 10 10 10 10 10 10 10 10 10 10 10 10 10 10 31 25 25 25 25 25 25
25 25 25 25 25 25 36 34 10 10 10 10 10 10 10 10 10 10 10 10 10 10 10 10 10 10 10 10 10 10 10 10 10 10 10 10 10 10 10 10 10 10 10 31 25 25 25 25 25 25
25 25 25 25 25 25 32 10 10 10 10 10 10 10 10 10 10 10 10 10 10 10 10 10 10 10 10 10 10 10 10 10 10 10 10 10 10 10 10 10 10 10 10 31 25 25 25 27 25 26
25 25 25 25 25 25 32 10 10 10 10 10 10 10 10 10 10 10 10 10 10 10 10 10 10 10 10 10 10 10 10 10 10 10 10 10 10 10 10 10 10 10 10 31 25 25 25 25 25 25
26 25 25 25 25 25 32 10 10 10 10 10 10 10 10 10 10 10 10 10 10 10 10 10 10 10 10 10 10 10 10 10 10 10 10 10 10 10 10 10 10 10 10 31 25 25 25 25 25 25
25 25 25 25 25 25 32 10 10 10 10 10 10 10 10 10 10 10 10 10 10 10 10 10 10 10 10 10 10 10 10 10 10 10 10 10 10 10 10 10 10 10 10 31 25 25 25 25 25 25
27 25 25 25 25 25 32 10 10 10 10 10 10 10 10 10 10 10 10 10 10 10 10 10 10 10 10 10 10 10 10 10 10 10 10 10 10 10 10 10 10 10 10 31 25 25 25 25 25 25
25 25 25 25 25 25 32 10 10 10 10 10 10 10 10 10 10 10 10 10 10 10 10 10 10 10 10 10 10 10 10 10 10 10 10 10 10 10 10 10 10 10 10 31 25 25 26 25 25 25
25 25 27 26 25 25 32 10 10 10 10 10 10 10 28 30 30 30 29 10 10 10 10 10 10 10 10 10 10 10 10 10 10 10 10 10 10 10 10 10 28 30 30 39 25 25 27 25 25 25
25 25 25 25 25 25 32 10 10 10 10 10 10 28 39 25 25 25 32 10 10 10 10 10 10 10 10 10 10 10 10 10 10 10 10 10 10 10 10 10 31 27 25 25 25 25 25 25 25 27
25 25 25 25 25 25 32 10 10 10 10 28 30 39 25 36 35 35 34 10 10 10 10 10 10 10 10 10 10 10 10 10 10 10 10 10 10 10 10 10 31 25 25 25 25 25 25 26 25 25
25 25 25 25 25 25 32 10 10 28 30 39 25 25 36 34 10 10 10 10 10 10 10 10 10 10 10 10 10 10 10 10 10 10 10 10 10 10 10 10 31 27 25 25 25 25 25 25 25 25
27 25 25 25 25 25 32 10 28 39 25 25 36 35 34 10 10 10 10 10 10 10 10 10 10 10 10 10 10 10 10 10 10 10 10 10 10 10 10 10 31 25 25 25 25 26 25 25 25 25
25 26 25 25 25 25 38 30 39 25 36 35 34 10 10 10 10 10 10 10 10 10 10 10 10 10 10 10 10 10 10 10 10 10 10 10 10 10 10 10 31 25 25 25 25 25 25 25 25 25
25 25 25 25 25 25 25 25 25 25 32 10 10 10 10 10 10 10 10 10 10 10 10 10 10 10 10 10 10 10 10 10 10 10 10 10 10 10 10 10 33 35 35 37 25 25 25 25 25 25
25 25 27 25 25 25 36 35 35 35 34 10 10 10 10 10 10 10 10 10 10 10 10 10 10 10 10 10 10 10 10 10 10 10 10 10 10 10 10 10 10 10 10 31 25 25 25 25 25 25
25 25 25 25 25 25 32 10 10 10 10 10 10 10 10 10 10 10 10 10 10 10 10 10 10 10 10 10 10 10 10 10 10 10 10 10 10 10 10 10 10 10 10 31 25 25 27 25 25 25
25 25 25 25 25 25 32 10 10 10 10 10 10 10 10 10 10 10 10 10 10 10 10 10 10 10 10 10 10 10 28 30 30 30 30 30 30 29 10 10 10 10 10 31 25 25 26 25 25 25
25 25 25 26 25 25 32 10 10 10 10 10 10 10 10 10 10 10 10 10 10 10 10 10 10 10 10 10 10 10 31 10 10 10 10 10 10 32 10 11 10 10 10 31 25 25 25 25 25 25
25 25 25 25 25 25 32 10 10 10 10 10 10 10 10 10 10 10 10 10 10 10 10 10 10 10 10 10 10 10 31 10 10 10 10 10 10 32 10 10 10 10 10 31 25 25 25 25 27 25
27 25 25 25 25 25 32 10 10 10 10 10 10 10 10 10 10 10 10 10 10 10 10 10 10 10 10 10 10 10 31 10 10 10 10 10 10 32 10 10 10 10 10 31 25 25 25 25 25 25
25 26 25 25 25 25 32 10 10 10 10 10 10 10 10 10 10 10 10 10 10 10 28 30 30 30 30 30 30 30 39 10 10 10 10 10 10 32 10 10 10 11 28 39 25 25 25 25 25 26
25 25 25 25 25 25 38 30 30 30 30 30 30 30 30 30 30 30 30 30 30 30 39 10 10 10 10 10 10 10 10 10 10 10 10 10 10 38 30 30 30 30 39 26 25 25 25 25 25 25
25 25 27 25 25 25 25 25 25 25 25 25 25 25 25 25 25 25 25 25 25 25 25 25 25 25 25 25 25 25 25 25 25 25 25 25 25 25 25 25 25 25 25 25 25 25 26 25 25 27
25 25 25 25 25 25 25 27 25 25 25 26 25 25 27 25 25 25 25 25 25 25 25 25 25 25 25 25 26 25 25 25 25 25 25 25 25 25 25 27 26 25 25 25 25 25 25 25 25 25
27 25 25 25 25 25 25 25 25 25 25 25 25 25 25 25 25 25 25 27 25 25 25 25 27 25 25 25 25 25 27 25 25 25 25 25 25 25 25 25 25 25 25 25 25 25 26 25 25 25
25 25 25 25 25 25 25 25 25 27 25 25 25 25 25 25 25 26 25 25 25 25 25 25 25 25 25 25 25 25 25 25 26 25 25 25 25 25 25 25 25 25 25 25 25 25 27 25 25 25
25 26 25 27 25 25 25 25 25 25 25 25 27 25 25 25 25 25 25 25 25 25 27 25 25 25 25 25 25 25 25 25 25 25 25 27 25 25 25 25 26 25 25 25 25 25 25 25 26 25
27 25 25 25 25 25 25 25 25 25 25 25 25 25 25 25 25 25 25 25 25 25 25 25 25 25 25 25 25 25 25 25 25 25 25 25 25 25 25 25 25 25 25 25 27 25 25 25 25 25